,0,1,2,3,4,5,6
0,DATE,TRANSACTIONID,MODE,ACCOUNT NO.,STATUS,AMOUNT,BALANCE
1,7/27/2023,1005,UPI(Transfer from ARYAN,7940418579,Cr,80000,80000
2,7/27/2023,1006,UPI(Transfer to ABHISHEK),2497653801,Dr,33000,47000
3,7/27/2023,1007,UPI(Transfer to TEJAS),2173014683,Dr,5000,42000
4,7/27/2023,1008,UPI(Transfer to RAHUL),3665537576,Dr,16000,26000
5,7/27/2023,1009,UPI(Transfer to RAJKUMAR),2842027745,Dr,6700,19300
6,7/27/2023,1010,UPI(Transfer to MUKUND),7542630333,Dr,5300,14000
7,7/27/2023,1011,UPI(Transfer to ANIL),1734168306,Dr,14000,0
