,0,1,2,3,4,5,6
0,DATE,TRANSACTIONID,MODE,ACCOUNT NO,STATUS,AMOUNT,BALANCE
1,7/27/2023,1102,UPI(Transfer from Abhishek),2497653801,Cr,3000,8000
2,7/27/2023,1111,UPI(Transfer to Aakash),7825063194,Dr,1100,6900
3,7/27/2023,1112,UPI(Transfer to Meera),7326091845,Dr,200,6700
4,7/28/2023,1113,UPI(Transfer to Rohan),7189350264,Dr,150,6550
5,7/28/2023,1114,UPI(Transfer to Priya),7385029164,Dr,260,6290
6,7/28/2023,1115,UPI(Transfer to Arjun ),8475132096,Dr,1280,5010
