,0,1,2,3,4,5,6
0,DATE,TRANSACTIONID,MODE,ACCOUNT NO.,STATUS,AMOUNT,BALANCE
1,7/27/2023,1103,UPI(Transfer from Abhishek),2497653801,Cr,7500,10000
2,7/27/2023,1121,UPI(Transfer to Kriti),7264910385,Dr,4000,6000
3,7/27/2023,1122,ATM WDL-ATM CASH 85641,,Dr,500,5500
4,7/27/2023,1123,UPI(Transfer to Shreya),5098436721,Dr,2400,3100
5,7/27/2023,1124,UPI(Transfer to Divya),9138475206,Dr,700,2400
6,7/28/2023,1125,UPI(Transfer to Kartik),3570168294,Dr,1100,1300
