,0,1,2,3,4,5,6
0,DATE,TRANSACTIONID,MODE,ACCOUNT NO.,STATUS,AMOUNT,BALANCE
1,7/27/2023,1006,UPI(Transfer to AVINASH),9623745108,Cr,33000,38000
2,7/27/2023,1101,ATM WDL-ATM CASH 21389,,Dr,1000,37000
3,7/27/2023,1102,UPI(Transfer to Aarav),3194587026,Dr,3000,34000
4,7/27/2023,1103,UPI(Transfer to Neha),9125730486,Dr,7500,26500
5,7/28/2023,1104,UPI(Transfer to Ravi ),2187945360,Dr,13800,12700
6,7/28/2023,1105,UPI(Transfer to Sneha),9782634150,Dr,8700,4000
