,0,1,2,3,4,5,6
0,DATE,TRANSACTION ID,MODE,ACCOUNT NO.,STATUS,AMOUNT,BALANCE
1,7/27/2023,1202,UPI(Transfer fromTEJAS),2173014683,Cr,3000,10000
2,7/27/2023,1701,ATM WDL-ATM CASH 78469,,Dr,10000,0
3,7/28/2023,1402,UPI(Transfer from RAJKUMAR),2842027745,Cr,3700,3700
4,7/28/2023,1332,UPI(Transfer to Deepika),5869123047,Cr,6000,9700
5,7/28/2023,1702,ATM WDL-ATM CASH 67418,,Dr,9700,0
6,7/29/2023,1143,UPI(Transfer from Senha),9782634150,Cr,5200,5200
7,7/29/2023,1703,ATM WDL-ATM CASH 75912,,Dr,5200,0
